11 11
.....#.#W#.
...#B###D##
....##3DGDE
#...P###D##
...#.#.#M#.
######.###.
....##.....
...P.#.....
.....#.....
#.#..#.....
#B.B##.....
13 URRRLRLLRLLLR

