11 11
..#..#.#W#.
....B###D##
..B.##3DGDE
.##..###D##
.BP..#.#M#.
######.###.
#...##.....
....##.....
#....#.....
...P.#.....
.BB.##.....
18 LLLRRLRRLRRRRRLRRL

