11 11
..#..#.#W#.
....B###D##
..B.##3DGDE
.##..###D##
.BP..#.#M#.
######.###.
#..#P#.....
...#.#.....
.....#.....
B...##.....
B..#.#.....
11 ULRRLRRRLRR

