11 11
.#..##.#W#.
.#P..###D##
B....#3DGDE
#.##.###D##
.....#.#M#.
######.###.
#.P..#.....
..#..#.....
#....#.....
.B..##.....
#B...#.....
9 RLLLRLLRR

