11 11
P#.#.#.#W#.
.....###D##
#....#3DGDE
....####D##
#.#B##.#M#.
######.###.
.#.P.#.....
.#...#.....
.#...#.....
...#.#.....
B.#.B#.....
12 RRLRLLLRRRRL

