11 11
.#.#.#.#W#.
..#..###D##
P....#3DGDE
#.#..###D##
.B.B.#.#M#.
######.###.
.#...#.....
#....#.....
##..P#.....
...B.#.....
BB.#B#.....
10 LLLRRRLLLL

