11 11
#..#P#.#W#.
...#.###D##
.....#3DGDE
B...####D##
B..#.#.#M#.
######.###.
#..P.#.....
.B#..#.....
.#..##.....
#....#.....
.B##.#.....
9 ULLLRLLLR

