11 11
#..###.#W#.
.....###D##
..#..#3DGDE
.P...###D##
##B.B#.#M#.
######.###.
.#...#.....
#....#.....
##..P#.....
...B.#.....
BB.#B#.....
12 LLLRRRLLRLLL

