11 11
#..###.#W#.
....P###D##
.#...#3DGDE
....####D##
..B..#.#M#.
######.###.
#..P.#.....
.B#..#.....
.#..##.....
#....#.....
.B##.#.....
9 ULLLRLLLR

