11 11
....##.#W#.
...P.###D##
.....#3DGDE
#.#..###D##
#B.B##.#M#.
######.###.
.#.P.#.....
.#...#.....
.#...#.....
...#.#.....
B.#.B#.....
12 RRLRLLLRRRLR

