11 11
#..P.#.#W#.
.B#..###D##
.#..##3DGDE
#....###D##
.B##.#.#M#.
######.###.
..#..#.....
.....#.....
.B#..#.....
.#...#.....
.P#.##.....
11 ULLLRLRRRLR

