11 11
#..P.#.#W#.
.B#..###D##
.#..##3DGDE
#....###D##
.B##.#.#M#.
######.###.
.#...#.....
#....#.....
##..P#.....
...B.#.....
BB.#B#.....
14 LLLRLLLRLRRRLR

