11 11
....##.#W#.
...P.###D##
.....#3DGDE
#.#..###D##
#B.B##.#M#.
######.###.
#..P.#.....
.B#..#.....
.#..##.....
#....#.....
.B##.#.....
10 RRLLLRLLLR

