11 11
....##.#W#.
#P...###D##
...#.#3DGDE
.....###D##
.B##.#.#M#.
######.###.
.#..##.....
.#.B##.....
#..#.#.....
.P.#.#.....
B.B.B#.....
14 ULLRLLLLLLRLLR

