11 11
..#..#.#W#.
....B###D##
..B.##3DGDE
.##..###D##
.BP..#.#M#.
######.###.
.#...#.....
....B#.....
....##.....
..P.##.....
#.BBB#.....
13 LRRLLLLLRLLRR

