11 11
..#..#.#W#.
....B###D##
..B.##3DGDE
.##..###D##
.BP..#.#M#.
######.###.
.#...#.....
#....#.....
##..P#.....
...B.#.....
BB.#B#.....
11 LLLRRRLRRLR

