11 11
.#.P.#.#W#.
.#...###D##
.#...#3DGDE
...#.###D##
B.#.B#.#M#.
######.###.
#..P.#.....
.B#..#.....
.#..##.....
#....#.....
.B##.#.....
13 ULLLRRRLRRLLR

