11 11
.#.P.#.#W#.
.#...###D##
.#...#3DGDE
...#.###D##
B.#.B#.#M#.
######.###.
#..#.#.....
#....#.....
....P#.....
.#...#.....
..#.B#.....
13 LLRRLRRRLRRLL

