11 11
.....#.#W#.
P....###D##
.#...#3DGDE
.#B..###D##
B###.#.#M#.
######.###.
.#...#.....
#....#.....
##..P#.....
...B.#.....
BB.#B#.....
10 LLLLRRRRRR

